R 1920 1080
C 0,153,255
F 247,220,111
NO ./texture/elon.xpm
WE ./texture/ponce.xpm
SO ./texture/slap.xpm
EA ./texture/stronk.xpm
S ./texture/free.xpm

1111111111111111
1000000000020001
1000000100020001
1000000100020001
1000000100020001
1111111100000001
1000000000000001
1000000000010001
10000000N0000001
1000000000000001
1111111001111111
1000000000000001
1010000110010001
1010001001010001
1010001001010001
1011100110011101
1000000000000001
1111111111111111